XXXXXXXXXXXXXXXXXXXXXXXXXXXXXXXXXXXXXXXXXXXXXXXXX
P   X             X               X   X   X     X
X X X XXXXXXXXX XXX XXXXX XXXXXXX X X X X X XXX X
X X   X       X     X   X X     X   X   X   X   X
X XXXXX XXXXX XXXXXXX X X X X XXX XXXXXXXXXXX XXX
X     X     X X       X   X X     X   X   X   X X
XXXXX X XXXXX X XXXXX XXXXXXXXXXX X X X X X XXX X
X     X X     X X     X         X X X   X X     X
X XXXXX X XXX X XXXXXXX XXXXXXX XXX XXXXX XXXXXXX
X     X X X   X X       X   X X     X   X       X
XXXXX XXX XXXXX X XXXXXXX X X XXXXXXX X XXXXXXX X
X X   X   X   X           X   X     X X     X X X
X X XXX XXX X XXXXXXXXX XXXXX X XXX X XXXXX X X X
X X X     X X   X     X X X     X X X     X   X X
X X X XXX X XXX X X XXX X XXXXXXX X XXXXX XXX X X
X   X   X X X X X X X   X     X   X X     X X X X
X XXX XXX X X X XXX X XXXXXXX XXX X X XXXXX X X X
X X   X   X   X   X     X     X   X X     X   X X
X XXX X XXXXX XXX XXXXX X XXXXX XXX X XXX XXXXX X
X   X X     X   X     X X X         X   X     X X
XXX X XXX XXXXX XXXXX XXX X XXXXXXXXXXXXXXXXX X X
X X X X   X     X   X   X X X                 X X
X X XXX X X XXXXX X XXX X X X X XXXXXXXXXXX XXX X
X X     X X X   X X X   X X X X   X       X X   X
X XXXXXXX X X XXX X X XXX X XXX X X XXXXX XXX X X
X X       X X   X X X   X X   X X X X         X X
X X XXXXXXX XXX X X XXX X XXX X X X XXXXXXXXXXX X
X   X     X   X   X   X X   X X X X     X   X   X
X XXX XXX XXX X XXXXX X XXX X XXX XXXXX X XXX XXX
X X     X X X X     X X     X     X X   X   X X X
X XXXXX X X X XXXXXXX XXXXXXXXXXX X X XXX X X X X
X   X   X   X   X     X         X   X X   X X   X
XXX X XXXXX XXX X XXX X XXXXXXX XXX X X XXX XXX X
X X   X   X   X   X X X X     X     X X   X     X
X XXXXXXX XXX XXXXX X XXX XXX XXXXXXX XXXXXXX XXX
X X       X   X     X   X   X X     X       X   X
X X X XXX X XXX X X XXX X X X X XXX X XXXXX XXXXX
X   X X X X   X X X X X X X X   X   X   X X     X
X XXX X X XXX XXX X X X XXX XXXXXXX XXX X XXXXX X
X X   X   X   X   X X X   X       X X       X   X
X X XXXXXXX XXX XXX X XXX XXXXXXX X XXXXX XXX X X
X X X   X   X   X   X   X         X     X X   X X
XXX X X X XXX XXXXX XXX XXXXXXXXXXXXXXX XXX XXX X
X   X X   X       X             X   X X   X X   X
X X X XXXXXXXXX X XXXXXXXXXXXXX X X X XXX X XXXXX
X X X X       X X     X       X X X   X   X     X
X XXX XXX XXX XXXXXXX X XXXXX X X XXX X XXXXXXX X
X         X           X     X     X   X         K
XXXXXXXXXXXXXXXXXXXXXXXXXXXXXXXXXXXXXXXXXXXXXXXXX
